{
    "id":  "central_03",
    "width":  31,
    "height":  21,
    "rows":  [
                 "FFFFFFFFFFFFFFFFFFFFFFFFFFFFFFF",
                 "FFFFFFFFFFFFFFFFFFFFFFFFFFFFFFF",
                 "FFFFFFFFFFFFFFFFFFFFFFFFFFFFFFF",
                 "FFFFFFFFFFFFFFFFFFFFFFFFFFFFFFF",
                 "FFFFWWWWWWWFFFFFFFFFWWWWWWWFFFF",
                 "FFFFWFFFFFWFFFFWFFFFWFFFFFWFFFF",
                 "FFFFNFFFFFFFFFFWFFFFFFFFFFNFFFF",
                 "FFFFWFFHFFFFFFFWFFFFFFTHTFWFFFF",
                 "FFFFWFFFFFFFFFFWFFFFFFTTTFFFFFF",
                 "FFFFWFFFFFFFFFFWFFFFFFTTTFWFFFF",
                 "FFFFWWNNWWNWFFFFFFFWWWWWWWWFFFF",
                 "FFFFWFFFFFFFFFFWFFFFFFFFFFWFFFF",
                 "FFFFWFFFFFFFFFFWFFFFFFFFFFWFFFF",
                 "FFFFWFFHFFFFFFFWFFFFFFFHFFWFFFF",
                 "FFFFNFFFFFFFFFFWFFFFFFFFFFNFFFF",
                 "FFFFWFFFFWWFFFFWFFFFWWFFFFWFFFF",
                 "FFFFWWWWWWCFFFFFFFFFCWWWWWWFFFF",
                 "FFFFFFFFFFFFFTTTTTFFFFFFFFFFFFF",
                 "FFFFFFFFFFFFFTTTTTFFFFFFFFFFFFF",
                 "FFFFFFFFFFFFFFFFFFFFFFFFFFFFFFF",
                 "FFFFFFFFFFFFFFFFFFFFFFFFFFFFFFF"
             ]
}
