{
    "id":  "central_04",
    "width":  31,
    "height":  21,
    "rows":  [
                 "FFFFFFFFFFFFFFFFFFFFFFFFFFFFFFF",
                 "FFWWWWWWWWWWTFFFFFTWWWWWWWWWWFF",
                 "FFWFFFFFFFFFTTTTTTTFFFFFFFFFWFF",
                 "FFWFFFFFFFFFFFFFFFFFFFFFFFFFWFF",
                 "FFWFFWWWWWWWWCCCCCWWWWWWWWTTWFF",
                 "FFWFFWCFFFFFFFFFFFFFFFFFCWTTWFF",
                 "FFWFFWFFFFFFFFFFFFFFFFFFFWTTWFF",
                 "FFWFFWTTWWWWWWWWWWWWWWWFFWTTWFF",
                 "FFWFFWTTWFFFFFFFFFFFFFWFFWFFFFF",
                 "FFWFFFFFCFFFFFFHFFFFFFNFFWFFFFF",
                 "FFWFFFFFCFFFFFHFHFFFFFNFFWFFFFF",
                 "FFWFFFFFCFFFFFFHFFFFFFNFFWFFFFF",
                 "FFWFFWFFWFFFFFFFFFFFFFWFFWFFFFF",
                 "FFWFFWFFWWWWWWWWWWWWWWWFFWFFWFF",
                 "FFWFFWFFFFFFFFFFFFFFFFFFFWFFWFF",
                 "FFWFFWCFFFFFFFFFFFFFFFFFCWFFWFF",
                 "FFWTTWWWWWWWWCCCCCWWWWWWWWFFWFF",
                 "FFWTTTFFFFFFFFFFFFFFFFFFFFFFWFF",
                 "FFWFFFFFFFFFFFFFFFFFFFFFFFFFWFF",
                 "FFWWWWWWWWFFFFWNWFFFFWWWWWWWWFF",
                 "FFFFFFFFFFFFFFFFFFFFFFFFFFFFFFF"
             ]
}
