{
  "id": "central_01",
  "width": 31,
  "height": 21,
  "rows": [
    "FFFFFFFFFFFFFFFFFFFFFFFFFFFFFFF",
    "FFFFFFFFFFFFFFFFFFFFFFFFFFFFFFF",
    "FFFWWWWWFFFFFFFFFFFFFFFWWWWWFFF",
    "FFFWFFFFFFFFFFFFFFFFFFFFFFFWFFF",
    "FFFNFFFFFFFFFFFFFFFFFFFFFFFNFFF",
    "FFFFFFFFFFFFFFFFFFFFFFFFFFFFFFF",
    "FFFFFFFFFFFFFFFFFFFFFFFFFFFFFFF",
    "FFFFFFFFFFFWWWWWWWWWFFFFFFFFFFF",
    "FFFFFFFFFFFFFFFFFFFFFFFFFFFFFFF",
    "FFFFFFFFFFFFFFFFFFFFFFFFFFFFFFF",
    "FFFFFFFFFFFFFFFFFFFFFFFFFFFFFFF",
    "FFFFFFFFFFFFFFTTTTFFFFFFFFFFFFF",
    "FFFFFFFFFFFWWWWWWWWWFFFFFFFFFFF",
    "FFFFFFFFFFFFFFFFFFFFFFFFFFFFFFF",
    "FFFFFFFFFFFFFFFFFFFFFFFFFFFFFFF",
    "FFFNFFFFFFFFFFFFFFFFFFFFFFFNFFF",
    "FFFWFFFFFFFFFFFFFFFFFFFFFFFWFFF",
    "FFFWWWWWFFFFFFFFFFFFFFFWWWWWFFF",
    "FFFFFFFFFFFFFFFFFFFFFFFFFFFFFFF",
    "FFFFFFFFFFFFFFFFFFFFFFFFFFFFFFF",
    "FFFFFFFFFFFFFFFFFFFFFFFFFFFFFFF"
  ]
}
