{
    "id":  "central_05",
    "width":  31,
    "height":  21,
    "rows":  [
                 "FFFFFFFFFFFFFFFFFFFFFFFFFFFFFFF",
                 "FFFFFFFFFFFFFFFFFFFFFFFFFFFFFFF",
                 "FFFWWWWWNWWWFFFFFFFWWWNWWWWWFFF",
                 "FFFWHFFFWFFFFFFFFFFFFFWTTTTWFFF",
                 "FFFWFFFFWFFFFFFFFFFFFFFTTTTWFFF",
                 "FFFWFFFFFFFFFFFFFFFFFFWTTTTWFFF",
                 "FFFWWWWWWWWWWWWWWWWWWWWTTTTWFFF",
                 "FFFWFFFFTFFFFFFFFFFFFFWFFFFWFFF",
                 "FFFWFFFFTFFFFFFFFFFFFFWFFFFWFFF",
                 "FFFFFFFFTFFFFFFHFFFFFFWFFFFFFFF",
                 "FFFFFCFFTFFFFFHFHFFFFFWFFCFFFFF",
                 "FFFFFFFFTFFFFFFHFFFFFFWFFFFFFFF",
                 "FFFFFFFFWFFFFFFFFFFFFFWFFFFWFFF",
                 "FFFFFFFFWFFFFFFFFFFFFFWFFFFWFFF",
                 "FFFWWWWWWWWWWWWWWWWWWWWWWFWWFFF",
                 "FFFWFFHFWFFFFFFFFFFFFFWFFFFWFFF",
                 "FFFWFFFFWFFFFFFFFFFFFFWFFFFWFFF",
                 "FFFFFFFFWFFFFFFFFFFFFFWHFFFWFFF",
                 "FFFWWWWWNWWWFFFFFFFWWWNWWWWWFFF",
                 "FFFFFFFFFFFFFFFFFFFFFFFFFFFFFFF",
                 "FFFFFFFFFFFFFFFFFFFFFFFFFFFFFFF"
             ]
}
