{
    "id":  "central_02",
    "width":  31,
    "height":  21,
    "rows":  [
                 "FFFFFFFFFFFFFFFFFFFFFFFFFFFFFFF",
                 "FFFFFFFFFFFFFFFFFFFFFFFFFFFFFFF",
                 "FFFWWWWWFFFFFFFFFFFFFFFWWWWWFFF",
                 "FFFWFFFFFFFFFFFFFFFFFFFFFFFWFFF",
                 "FFFWFWWWWWWWFFFFFFFWWWWWWWFWFFF",
                 "FFFWFFFWFFFFFFFFFFFFFFFWFFFWFFF",
                 "FFFWFFFWFFCFFFFFFFFFCFFWFFFWFFF",
                 "FFFWFFFWFFFFFFFFFFFFFFFWFFFWFFF",
                 "FFFWFTFWFFFFFFFFFFFFFFFWFFFWFFF",
                 "FFFWTTFWFFFFFFFHFFFFFFFWFFFWFFF",
                 "FFFNTTFWFFFFFFHFHFFFFFFWFFFNFFF",
                 "FFFWTTFWFFFFFFFHFFFFFFFWFFFWFFF",
                 "FFFWFTFWFFFFFFFFFFFFFFFWFFFWFFF",
                 "FFFWFFFWFFFFFFFFFFFFFFFWFFFWFFF",
                 "FFFWFFFWFFCFFFFFFFFFCFFWFFFWFFF",
                 "FFFWFFFWFFFFFFFFFFFFFFFWFFFWFFF",
                 "FFFWFWWWWWWWFFFFFFFWWWWWWWFWFFF",
                 "FFFWFFFFFFFFFFFFFFFFFFFFFFFWFFF",
                 "FFFWNWNNFFFFFFFFFFFFFFFWWWWWFFF",
                 "FFFFFFFFFFFFFFFFFFFFFFFFFFFFFFF",
                 "FFFFFFFFFFFFFFFFFFFFFFFFFFFFFFF"
             ]
}
