{
    "id":  "central_06",
    "width":  31,
    "height":  21,
    "rows":  [
                 "FFFFFFFFFFFFFFFFFFFFFFFFFFFFFFF",
                 "FFFFFFFFFFFFFFFFFFFFFFFFFFFFFFF",
                 "FFFWWWWWWWWWWWFFFWWWWWWWWWWWFFF",
                 "FFFWFFFFWFFFFFFFFFFFWFFFFFFWFFF",
                 "FFFWFHFFWFFFFFFFFFFFWFFFFFFWFFF",
                 "FFFWFFFFWFFFFFFFFFFFWFFFFFFWFFF",
                 "FFFWFFFFWWWWWFFFFFWWWFFFFFFWFFF",
                 "FFFWFFFFWFFFFFFFFFFCWFFFFFFWFFF",
                 "FFFWWWWCWFFFFFFHFFFFWFFFFFFWFFF",
                 "FFFFFFFFFFFFFFFFFFFFFFFFFFFFFFF",
                 "FFFFFFFFFFFFTHTTTHTFFFFFFFFFFFF",
                 "FFFFFFFFFFFFFFFFFFFFFFFFFFFFFFF",
                 "FFFWFFFFWFFFFFFHFFFFWFFFFFFWFFF",
                 "FFFWFFFFWCFFFFFFFFFFWFFFFFFWFFF",
                 "FFFWFFFFWWWWWFFFFFWWWFFFFFFWFFF",
                 "FFFWFFFFFFFFFFFFFFFFWFFFFFFWFFF",
                 "FFFWFFFFFFFFFFFFFFFFWFFFFFFWFFF",
                 "FFFWFFFFWFFFFFFFFFFFWFFFFFFWFFF",
                 "FFFWWWWWWFFFFFFFFFFFWWNNWWFWFFF",
                 "FFFFFFFFFFFFFFFFFFFFFFFFFFFFFFF",
                 "FFFFFFFFFFFFFFFFFFFFFFFFFFFFFFF"
             ]
}
